........##..##.
.##..#.##...##.
..##...#.#.#...
#..#...#...#..#
..##....#.#..#.
#.###.....#....
....##.##...###
###....#...#...
#....#....###..
..#............
......###...###
..###.....#....
...#...##......
...............
...............